■■■■■■■■■■■■■■■■■■■■■■■■■■■■■
■　　　□□□　　　　♥　　　　　　□□□□□□　　　　■
■　■　■　■　■　■　■　■　■　■　■　■□■　■　■
■　□□□□□　　　　　　□□　　□　□□□□□□□□□■
■　■　■　■　■　■　■　■　■□■　■□■　■　■　■
■　　　　　　　□□□　　　　　　　●　　　　　　　　　■
■　■　■　■　■　■　■　■　■　■　■　■　■　■　■
■　　　□　　　　　　　　　　　　　　　　　　　　　　　■
■　■　■　■　■　■　■　■　■　■　■　■　■　■　■
■　　　　□□□□　　　　　　　　　　　　　　　　　　　■
■　■　■　■□■　■　■　■　■□■□■　■　■　■　■
■　　　　　　　　　▶　　　　　　　　　　　　　　　　　■
■　■□■　■　■　■　■　■　■　■●■　■　■　■　■
■　　□　　□□□□□　　　　□□□□□□□　　□□□□■
■　■　■　■　■　■　■　■　■　■　■　■　■　■　■
■　　　　　　　　　　　　　　　　　　　　　　　　　　　■
■■■■■■■■■■■■■■■■■■■■■■■■■■■■■